11111111111111111111
13331111133311111111
13031111131333333111
13133333331131133111
13131111111132133331
13111121133331133331
13111133111111113333
13111111131111131163
13111111133331111153
13121111111111131163
13111111131111133333
13333333333333331111