333333333333
311011111113
311111111113
311111111113
311133311213
311111121113
311133311113
311111113313
313311111113
311111131113
341111111143
333333333333